W.Sg...........gs.w
##g#############g##
...#ggg.....ggg#...
##.#g##..g..##g#.##
.#.#g#...g...#g#.#.
.#.#.....g.....#.#.
...#.....g.....#...
...g.ggggggggg.g...
...#.....g.....#...
...#.....g.....#...
...###...g...###...
...#r#########r#...
...#rrr.....rrr#...
...#....###....#...
........#r#........
